000000000000000000000
000000000000000000000
000000000100000000000
000000333333330000000
000001300000031000000
000000300000030000000
000000333333330000000
000000000100000000000
000000000000000000000
000000000000000000000