000000000000000000000
333330000000000333333
000030000000000300000
000002003333000020000
000000000100000000000
000000000000000000000
000002000000000020000
000030003333000300000
333330000000000333333